WWWWWWWWWW
WFGFFFFFFW
WFWWGWGWGW
WGWWFFFFFW
WFFGFWWFWW
WWWWFWWFW-
---WGWWFW-
---WFFFFW-
---WWWWPW-
------WWW-