WWWWWWWWWW
WFFFWFGFFW
WGWFFFWWFW
WFWWWFWFFW
WFFFFFWGWW
WFWWWWWFFW
WFWFGFWWFW
WFWFWFFFPW
WFGFWWWWWW
WWWWW-----