WWWWWWWWWW
WGFFPWFFGW
WFWFWWFWFW
WFWFFFFFFW
WFFGWFWFWW
WFWWWFWGWW
WFWFFFWFFW
WFWFWWWWFW
WGFFFFFFFW
WWWWWWWWWW