WWWWWWWWWW
WFGFFWFGFW
WFWWFWFWFW
WFWPFWFFFW
WFWWFFGWFW
WFFFGFWWFW
WFWFWFWWFW
WFWFWFFFGW
WGFFWWWWWW
WWWWW-----