WWWWWWWWWW
WFFFWWGFFW
WGWFFFFWFW
WWWFWWFFGW
--WGFFFWFW
WWWFWFWWFW
WFFFFFFFFW
WPWWWWFWGW
WFFFGFFFFW
WWWWWWWWWW