WWWWWWWWWW
WFFFWWFGFW
WFWGFFFWFW
WGFFFWPWFW
WFWWFWFFGW
WFWFFFFWWW
WFWGWWFW--
WFFFFFFW--
WWWWWWGW--
-----WWW--